   ###### 
 ###   @# 
##. $## ##
#..$ $   #
#.. $ $ ##
#####   # 
    ##### 