    ####               
    #  ###############
    #                # 
    #.######### #### # 
    #.#      ## #### ##
 ####.#########       #
 #  ####      #  ## # #
 #      $ $ $@##### # #
 # ################ # #
 # #                # #
## # ###### ######    #
#  # ###### #    ######  
#           #          
##########  #          
         ####          