####################
#                  #
#              . . #
#               @  #
#                . #
#                  #
#                  #
#                  #
#                  #
#                  #
#                  #
# $                #
#                  #
# $ $              #
#                  #
####################
