 ######
## . @#
# $ $ #
#. * .#
# $ $ #
## . ##
 ##### 