 ###### 
 #. ..# 
 #. $.# 
###  $##
# $  $ #
# #$## #
#  @   #
########