##########
#   @    #
# $$$$$$ #
#        #
#### #####
  #   ####
  #   ...#
  #   ####
  #   ...#
  ########