     #####
  ####   #
###  * $@#
#  * . *##
# $ ..  # 
### $#### 
  #  #    
  ####    