###########
#    .   @#
#  * $ *  #
### ### ###
#  * $ *  #
#    .    #
###########