########
# $. $.#
# +$ $.#
# $. $.#
# .$ $.#
########