########
# +$ . #
# * .$ #
#  *$ *#
# $.$  #
##.#####
 ###    