#####  
#@  #  
# #$###
#  $..#
#######