#######
#. . .#
# $$$ #
#.$@$.#
# $$$ #
#. . .#
#######
