  ######
  # @ .#
### # ##
#  $  # 
#  $ .# 
####### 