########
#.    .#
## @$ ##
## $$ ##
#     .#
########
