#####    
#  @#    
# $$# ### 
# $ # #.#
### ###.#
 ##    .#
 #   #  #
 #   ####
 #####   