#######
#     #
#$ $ $#
#     #
#     #
#     #
#     #
#     #
#     #
#     #
#     #
#  @  #
#     #
#.#.#.#
#######