#############
#... .      #
# $ $ $ $   #
#    @      #
#    $ $    #
#      . .  #
#############