 #######  
 #     ###
##$###   #
#   $  $ #
# ..# $ ##
##.+#   # 
 ######## 