#############
#..      .. #
# $$ $$ $$  #
#  $   $    #
#   ### ### #
# #   @   # #
# ######### #
#           #
#############