  #####
 ##.  #
## $# #
#.    #
# $$#.#
#  +$ #
#######