########################
# ........        #      # 
# @   $$$$$$$$    #      #
#                 #      #
########################