#######################
#                     #
#                 . . #
#                  +  #
#                 . . #
#                     #
#                     #
#                     #
#                     #
#                     #
#                     #
# $ $                 #
#  $                  #
# $ $                 #
#                     #
#######################
