            #####
#############   #
# $ $ $ $ $ $ # #
# # # # # # # # #
# #             #
# # ###### # # ##
#@. . . . . .   #
#########       #
        #########