#######################
##  #######           #
##          $ $ $ $ $@#
## ####################
## ####################
#  ################  ##
#                    ##
#################### ##
#################### ##
##  ################  #
##                    #
## ####################
## ####################
#  ####################
#                .....#
#######################
