#########
#      @#
# $.$.$ #
# .$.$. #
# $.*.$ #
# .$.$. #
# $.$.$ #
#       #
#########