   #####
   #.  #
   #...#
   #.  #
   #.  #
##### #####
#         #
# $@$$$$$ #
#    #    #
###########