    ##########
   ##   #    ##
####    #  #  #
#  $.******.$ #
#   #   @  #  #
#####    ######
    ######     