
########
#     .#
#@ $   #
#   $  #
# .   #
########
