      #####
  #####   #####
  #           #
  #  ### ###  #
#### #     # ####
#    #  *  #    #
# $  # *+*      #
#    #  *  #    #
#### #     # ####
  #  ### ###  #
  #           #
  #####   #####
      #####