
  #      #
 #   #  #
  # #  #
   # #  #
  #   #  #
 #   #  #
  # #  #
-
##########
#........####
# $$$$$$$#  #
#.$......#  #
# $$$$$$ #  #
#......$+#  #
#$$$$$$$ #  #
#        ####
##########