############################												
 #@          #             
########### #################
#.          #			
#        $  #	
#      $    #			
#           #
#     $     .#
#   .       # #
#############
#