#############
#####. . .###
###  .$$$ .#
###  #   # #
###. $ $ $ #
###. #$@$#.#
###  $ .$. #  
#. $ .$#$$.#
#          #  
##############     